1111
1CE1 
1C11
1Cx1
11C1
1PC1
1111