1111
1CE1
1C11
1C01
1011
1PC1
1111