1111111111111
1C11000110011
10P00100C1101
110110E00C001
1111111111111