11111111111
1P1C0C1C0C1
1C0C1C0C101
11111111101
1C0C1C0C101
1E1C0C1C0C1
1C111111111
11111111111