1111111111111
1E00000010011
1110110011101
11P000100C001
1111111111111