1111111111111
1E0000001C011
1110110000101
11P000100C001
1111111111111