11111111111111111111111111
1E00000C1C000000C00000C001
10000000110000011100010001
10011100100000000111000001
10000000000000000000000P01
1C000000000000000000000101
11110000000000000000000001
10C10000000000000100111001
100000000C0000000000000001
100000100C000000010000C001
11111111111111111111111111