1111111111111
10010000000C1
1000010011001
1P0100E000001
1111111111111