11111111111111111111111111
1E00000C1C000000C00000C001
11000000110000011100010001
10011100100000000111000001
10000000000000000000000P01
1C000000000000000000000101
11110000000000000000000001
10C10000e00000000100111001
1000000C100000000000000001
1000001C10000000010000C001
11111111111111111111111111